map4
17
23
2
baseUp.png
52
baseDown.png
52
spriteMap.png
pont.png
050030000j1j1j1j1j1000
63333000021dj121dj121d000
00000000000000000
00000000000000000
00000000000000000
00000000050000000
00000000000000000
00000500000000000
33433333300000000
00000000300000000
00000000300005000
00005000600050000
00050000300000000
00000000300000000
00000000333333433
00000000000050000
00000000000000000
00000005000000000
00000000000000000
00000000000000000
00000000000000000
00022uj222uj222u000033336
000j2j2j2j2j2000030050